1111111111111111111111111
1000000010000000011111111
1111100010000000011111111
5000000020000000011000007
1111100010000000011100011
1000000010000000000000006
1000000010000040000001111
1000000010000000000000001
1000000030000000000000001
1000000010000000000000001
1000000010000000000000008
1000000010000000000000001
1000000010000000000000001
1000000010000000000000001
1111111111111111111111111
5
5
2
4
4
4
0
