11111181111111111111111111
11100000001000000001000001
11100000001000000001000001
70000000001000000003000001
10000000001000000001000001
11110000001000000001000001
6000000000100000000000b001
10000000000000000000000001
100000000000000000a0000001
10000000000000000000000001
50000000000000000000000001
10000000000000000000000001
10000000000000000000000001
10000000000000000000000001
11111111111111111111111111
12
5
2
4
4
4
4
