1111111111111511111111111
1000000000000000000000001
1000000000000000000000001
1000000000000000000000001
6000000000000000000200001
1000040000000000000000001
1000000000000000000000001
1000000000000000000000008
1000000000000000000000001
1000000000000000000000001
100000000000000c000000001
1000000000000000000000001
1000000000000000000000001
1000000000000000000000001
1111111111711111111111111
10
3
1
4
4
4
4
