1111118111111111111111111
1110000000100000000100001
1110000000100000000100001
7000000000100000000300001
1000000000100000000100001
1111000000100000000100001
6000000000100000000000b01
1000000000000000000000001
100000000000000000a000001
1000000000000000000000001
5000000000000000000000001
1000000000000000000000001
1000000000000000000000001
1000000000000000000000001
1111111111111111111111111
12
5
2
4
4
4
4
